000000113000000000000000
020000011000000001111000
000010001100000001000000
111110000100000001000000
000000000110001111100000
000010000000000000110000
000011000000000000310000
000001000000000000010000
000001000000000011110000
000001000000100110011100
000011000000111100000100
000010000000000000000100
000000000000000000000100
000000000000000001020100
111000110000000001000100
001000011100000001111100
000300000000000000000000
000000000000000000000000
